#domain
hospital
#levelname
Bpriority1
#colors
blue: 0, A, E
red: 1, B
#initial
+++++++++++
+++++A+++++
+ 0   +   +
+     +   +
+E    +   +
+++++ + +++
+       1B+
+++++++++++
#goal
+++++++++++
+++++ +++++
+     +A  +
+     +   +
+     +  B+
+++++ + +++
+E        +
+++++++++++
#end
