#domain
hospital
#levelname
PRIORITIES00
#colors
blue: 0, A, B, C
#initial
+++++++++++
+ 0   +   +
+B    +   +
+++++ + +++
+         +
+     C  A+
+++++++++++
#goal
+++++++++++
+     +  A+
+     +   +
+++++ + +++
+B        +
+         +
+++++++++++
#end
