#domain
hospital
#levelname
MAPF03
#colors
blue: 0,A,B,C
#initial
+++++++++++++
+           +
+0AB     ++++
+        C  +
+        ++ +
+C        + +
+++++++++++++
#goal
+++++++++++++
+          A+
+        ++++
+           +
+        ++ +
+         +0+
+++++++++++++
#end
