#domain
hospital
#levelname
MAthomasAppartment
#colors
red: 0
#initial
                   +++++++++
                   +       +
++++++++++++++++++++       +
+      +     +     +       +
+      +     +     +       +
+      +     +     +       +
+      +     +     +       +
+                  +       +
+++++++++ + +++++++++  +++ +
+         +             +  +
+         +             +  +
+                       +  +
+                       +  +
+         +             +  +
+         +             +  +
+0        +             +  +
++++++++++++++++++++++++++++
#goal
                   +++++++++
                   +      0+
++++++++++++++++++++       +
+      +     +     +       +
+      +     +     +       +
+      +     +     +       +
+      +     +     +       +
+                  +       +
+++++++++ + +++++++++  +++ +
+         +             +  +
+         +             +  +
+                       +  +
+                       +  +
+         +             +  +
+         +             +  +
+         +             +  +
++++++++++++++++++++++++++++
#end
