#domain
hospital
#levelname
SAD4
#colors
blue: 0, A
red: 1, B
#initial
+++++++++++++++++++
+                 +
+0             ++++
+                 +
+   1          ++ +
+++++B++++A++++++ +
+++++ +++++++++++++
+++++++++++++++++++
#goal
+++++++++++++++++++
+             A  B+
+              ++++
+                 +
+              ++ +
+++++ ++++ ++++++ +
+++++ +++++++++++++
+++++++++++++++++++
#end
