#domain
hospital
#levelname
SAtest
#colors
blue: 0, A
red: 1, B
#initial
++++++++++++++++++++++++
+       A          B   +
+0                     +
+                1     +
+                      +
+        +++           +
+       ++   +++++++++++
++++++++++++++
#goal
++++++++++++++++++++++++
+                     B+
+                      +
+                      +
+                      +
+        +++           +
+       ++A  +++++++++++
++++++++++++++
#end
