#domain
hospital
#levelname
MAPF00
#colors
blue: 0, A
red: 1, B
#initial
++++++++++++
+  0  +AB  +
+     +    +
+          +
+          +
+1         +
++++++++++++
#goal
++++++++++++
+     +    +
+     +    +
+          +
+          +
+       BA +
++++++++++++
#end
