#domain
hospital
#levelname
MAPF00
#colors
blue: 0
red: 1
green: 2
cyan: 3
#initial
++++++++++++
+   1 0    +
+          +
+          +
+        2 +
+    3     +
+          +
++++++++++++
#goal
++++++++++++
+         0+
+          +
+          +
+          +
+          +
+1    3   2+
++++++++++++
#end
