#domain
hospital
#levelname
SimpleM
#colors
blue: 0,A,C
red: 1,D,E
#initial
++++++++++
+   C   E+
+ 0      +
+        +
+    D   +
+ A     1+
++++++++++
#goal
++++++++++
+C       +
+        +
+       A+
+        +
+E    D  +
++++++++++
#end
