#domain
hospital
#levelname
SAsimple0
#colors
blue: 0, A
green: 1, B
#initial
+++++++++++++++
+0 +++ B +++  +
+             +
+1 +++ A +++  +
+++++++++++++++
#goal
+++++++++++++++
+  +++   +++ A+
+             +
+  +++   +++ B+
+++++++++++++++
#end
