#domain
hospital
#levelname
MAPF00
#colors
blue: 0, A
red: 1, B
#initial
++++++++++++
+ 0 +BA    +
+   +  + + +
+      + + +
+      + + +
+ 1    + + +
++++++++++++
#goal
++++++++++++
+   +      +
+   +  + + +
+      + + +
+      + + +
+      +A+B+
++++++++++++
#end
