#domain
hospital
#levelname
WESDONK3
#colors
pink: 0, A, B, C
#initial
++++++++++++
+     +   ++
+     +   ++
+++++ + ++++
+C         +
+ ++      A+
+0 +  B    +
++++++++++++
#goal
++++++++++++
+    B+  A++
+     +   ++
+++++ + ++++
+          +
+ ++       +
+  +       +
++++++++++++
#end
