#domain
hospital
#levelname
WESDONK2-1
#colors
blue: 0
pink: 1, A
#initial
++++++++++++
+     +   ++
+     +   ++
+++++ + ++++
+0         +
+ ++      ++
+1 +A     ++
++++++++++++
#goal
++++++++++++
+     +  A++
+     +   ++
+++++ + ++++
+          +
+ ++      ++
+  +      ++
++++++++++++
#end
