#domain
hospital
#levelname
WESDONK2
#colors
blue: 0, C
cyan: 1, A, B
#initial
++++++++++++
+     +   ++
+     +   ++
+++++ + ++++
+C       0 +
+ ++      ++
+1 +  B  A++
++++++++++++
#goal
++++++++++++
+    B+  A++
+     +   ++
+++++ + ++++
+          +
+ ++      ++
+  +      ++
++++++++++++
#end
