#domain
hospital
#levelname
MAPF00
#colors
blue: 0, A
red: 1, B
purple: 2, C
brown: 3, D
#initial
+++++++++++++++
+ 0  A +      +
+      +      +
+++++  +    +++
+             +
+             +
++++++++      +
+1     +     ++
+B     +      +
+++++  +     D+
+  C        +++
+             +
+ 2         3 +
+++++++++++++++
#goal
+++++++++++++++
+      +     A+
+      +     B+
+++++  +    +++
+             +
+             +
++++++++     C+
+      +     ++
+      +     D+
+++++  +      +
+           +++
+             +
+             +
+++++++++++++++
#end
