#domain
hospital
#levelname
WESDONK0
#colors
blue: 0, A, B, C
#initial
++++++++++++
+ 0   +   ++
+     +   ++
+++++ + ++++
+    B     +
+         ++
+     C  A++
+++++ ++++++
++++++++++++
#goal
++++++++++++
+     +  A++
+     +   ++
+++++ + ++++
+C         +
+         ++
+         ++
+++++ ++++++
++++++++++++
#end
