#domain
hospital
#levelname
WESDONKO
#colors
blue: 0, A
red: 1, B
purple: 2, C
brown: 3, D
#initial
+++++++++++
+ 0  A+   +
+     +   +
+++++ + +++
+        B+
+         +
+++++++   +
+1    +  ++
+     +   +
+++++ +  D+
+  C    +++
+         +
+ 2     3 +
+++++++++++
#goal
+++++++++++
+     +  A+
+     +  B+
+++++ + +++
+         +
+         +
+++++++  C+
+     +  ++
+     +  D+
+++++ +   +
+       +++
+         +
+         +
+++++++++++
#end
