#domain
hospital
#levelname
WESDONK
#colors
blue: 0, A, E
red: 1, B
purple: 2, C
brown: 3, D, F
#initial
+++++++++++
+++++++   +
+ 0  A+   +
+E    +  ++
+++++ + +++
+         +
+ B       +
+++++++   +
++       ++
++   1+   +
+++++++   +
+C      +++
+ D     F++
++ ++     +
+ 2 +    3+
+++++++++++
#goal
+++++++++++
+++++++A  +
+     +   +
+     +  ++
+++++ + +++
+E        +
+        B+
+++++++  C+
++       ++
++    +   +
+++++++   +
+       +++
+        ++
++ ++    F+
+   +     +
+++++++++++
#end
