#domain
hospital
#levelname
WESDONK2-1
#colors
blue: 0, C, B
pink: 1, A
#initial
++++++++++++
+    B+   ++
+     +   ++
+++++ + ++++
+C       0 +
+ ++      ++
+1 +A     ++
++++++++++++
#goal
++++++++++++
+     +  A++
+     +   ++
+++++ + ++++
+          +
+ ++      ++
+  +     B++
++++++++++++
#end
