#domain
hospital
#levelname
WESDONK5
#colors
blue: 0, A
green: 1, B
cyan: 2, C
#initial
++++++++++++
+0    AB   +
+          +
+1         +
+          +
+ 2   C    +
+          +
++++++++++++
#goal
++++++++++++
+          +
+        AB+
+          +
+          +
+          +
+         C+
++++++++++++
#end
